111110111
1000000P1
1000C00E1
111111111
