111111111111
100200000E11
10000P000001
10000C000001
111111111111
