111111111
100000P1
10000001
1C000001
1E000001
11111111
