111111111111
100000P00001
100011100001
1E000000C001
100000000001
1000000C0001
111111111111
