11111111111111111111
10000010000011110001
10E000100C0011110001
1111100000000C001111
1000010100C001100011
1P000000001000010C01
11111111111111111111
